Label	Value
None	NN
Czech	CS
German	DE
Greek	EL
English (International)	EN
Italian	IT
Dutch	NL
Slovakian	SK
Arabic	AR
Bulgarian	BG
Danish	DA
Spanish	ES
Finnish	FI
French	FR
Norwegian	NO
Polish	PL
Portuguese	PT
Russian	RU
Swedish	SV
Estonian	ET
Hungarian	HU
Lithuanian	LT
Latvian	LV
Romanian	RO
Slovenian	SL
Serbian	SR
Turkish	TR
Ukrainian	UK
